e b b r b r y r w b r r w y r
e r b w r r b b r b y w r y r
e w r r r r r r b y w y b b b
e r r b b r b w w r r y y b r
e r r b r b r w y r b y b w r