e g y r r y b w b r r b b g w
e b y r b w g g r b b r r y w
e w b r y y g r r b r g b w b
e b r w w g r y y g b r r b b
e r w g w b b r y r g r b b y