e g y r r w p b w r b r g p y
e y g y r g b r w p r w r b p
e r r p w r b r y b g y p w g
e g r p y b b g w w r y r p r
e r y g b w w r b g r y r p p